{
  "levels": [
    "- - - c c -.- - - b - -.- 0 0 b - -.- - - b - -.- - - - - -.- - - - - -",
    "- - - - - -.- - - b - -.- 0 0 b - -.- - - b c c.- - - - - -.- - a a - -",
    "- - - d d d.- - - b - -.0 0 - b - -.- - - b c c.- - e e - -.- - a a - -",
    "- - d d d d.- - - b - -.- 0 0 b - f.- - - b - f.- - e e - -.- - a a - -",
    "- - - - - -.d d d b - v.- 0 0 b - v.c c c b - -.- - - - - -.- - - - - -",
    "- v v v - -.- d d b g g.- 0 0 b - -.- c c b - -.- - z z z -.- - - - - -",
    "- v v v - -.- d d b - -.0 0 m b - -.c c m b - -.z z m g g -.- - - - - -",
    "- v v v - -.- d d b - y.0 0 m b - y.c c m b - -.z z m g g -.- - - - - -"
  ]
}